{
    "45": 0,
    "62": 1,
    "48": 2,
    "66": 3,
    "81": 4,
    "73": 5,
    "56": 6,
    "71": 7,
    "_": 8,
    "47": 9,
    "68": 10,
    "r": 11,
    "59": 12,
    "80": 13,
    "52": 14,
    "57": 15,
    "67": 16,
    "75": 17,
    "65": 18,
    "61": 19,
    "53": 20,
    "58": 21,
    "70": 22,
    "63": 23,
    "69": 24,
    "79": 25,
    "76": 26,
    "54": 27,
    "50": 28,
    "55": 29,
    "78": 30,
    "64": 31,
    "60": 32,
    "72": 33,
    "77": 34,
    "74": 35,
    "51": 36,
    "/": 37
}